111111111111111
1E00P0000000001
111000000000C01
111111C11111111