1111111
1E00P01
100001
100C1
1111