11111111111111111
1000E000000000011
10000011110000111
1000P011000000111
11111111111111111