111111111
1E0000P01
10E000C01
111111111