11111111111111111
1000E000000000011
1000001111000C111
1000C011000000111
11111111111111111