1111111
1E00P01
1000001
10P0C01
1111111