111111111
100000P01
1C1111001
111100001
1E0000001
111111111