1111111111111111111111111
100C11000000000000000P001
1000100011000110000000001
1000001110000010001001001
1000C11000000001111C11001
101110000000C100001110011
111E000000001111001110C11
1111111111111111111111111