1111111111111111111
100C110000000000001
100010001100011P001
1000001110000010001
1000000000000001111
1011100000000100001
111E000000001111001
1111111111111111111