111111111111111
1P0000000000C11
101111011111101
1C00000100000E1
111101111011101
1C000C000000001
101111111110111
111111111111111