111111111111111111111111111111
1P00001100000000000000000000C1
10111110C111111111111111011101
1C000001000001C000010000010001
111010111101111101111101111101
1000100001010000000000010000E1
101111111101111111111101111101
1C0000000000001100000010000001
111101111101111111101111101101
1C001000000100000C100000001001
101110110111011111111011111101
1000001C000001000000001C000001
101111111111101110111111111101
100C000000001000000001000000C1
111111111111111111111111111111