111111111111111111111111111
1P00001100000000000000000C1
10111110C111111111111011101
1000000010001C0000100010001
111010111101110111101111101
10C0100001010000000010000E1
101111111011111111101111101
1000000000011C0000100000001
111101101111111101111101101
1C000100000000C100000000001
10111C110101111111011111101
1000001C001000C00001C000001
111111111111111111111111111
