111111111111111
1P00001000000C1
101110111011101
1C00000100000E1
111101011111101
1C0M0C010000001
101111010111011
100C000000000C1
111111111111111