1111111111111111111
1P0000001000C1000C1
1011111010111111101
1C000001C0000000001
11110101111011111M1
1C000C01000000000E1
1011110101111111101
1000000100C01000001
1011111011111011111
10000C000M0000000C1
1111111111111111111