111111111111111111111111111
1P00001100000000000000000C1
10111110C111111111111011101
1000000010C01C0000100010001
111010111101110111101111101
10C01000010000M0000010000E1
101111111011111111101111101
100M000000011C0000100000001
111101101111111101111101101
1C000100000000C100000000001
1011101101011111110111111M1
1000001C001000C00M010000001
11111C11111111101111C111101
111111111111111111111111111
