1111111111
1P00000C11
1011101011
1C00000E11
1000100C11
1111111111