1111111
1E00P01
1000001
1000C01
1101111