1111111111111111
1E00P00000011111
1000000000001111
1000C00000A00001
1111111111111111