111111111111111
1E10P0000000001
111000000000C01
111111111111111