1111111
1E00P01
1110001
1C10C01
1111111